EA ./textures/east.xpm
NO ./textures/north.xpm


WE ./textures/west.xpm
F 220,100,56
SO ./textures/south.xpm

C 233,100,255

1111111111111111111111111
1000000000000000000000001
1011110111111111111011101
10000100000000000100000001
10000100000000000100000010
1000010001111110010111101
1000000001000010010000001
1011111111000010010111101
1000000000000010010000001
1000000000000010010000001
1000000111111110010111101
1000000100000000010000001
1011111101111111110111101
1000000001000000000000001
1000000001000000000000001
1000000000000000000000001
1000000000000000000000001
1000000000000000S00000001
1000000000000010000000001
1111111111111111111111111
