EA ./textures/east.xpm
NO ./textures/north.xpm
SO ./textures/south.xpm
WE ./textures/west.xpm


F 220,100,0
C 100,100,255

111111
100001
101001
1000N1
111111